And = arn 
But = ex
Is = i' 
Yes = si
So = co
Or = altern 
No = no
How = ho
Of = o
The = de
Be/Is = i' 
Have = art
Make = fani
Very = mucho

Me = n'tu
We = w'tu
they = il'tu
you = do'tu
New = crono 

Fun = amusa 
Profile picture = expressify de pictora 
Death = mori
Tsa = hi
See = perceptify
Better/over = excessify
Me too = similify
Morning = sunnyriseyup
Noon = sunnyupahead
Afternoon sunnyafterupahead
Evening sunnygoeydown
Night = sunnyatbutthole
Sleep = sunnyatbutthole mori
Stupid = estupide
Question = querle
Clarify = clariate 
Project = aplicatia
Sees Referance = homaga
Magnet = electra
Magnetite = electro materali
Dice = randara cubos
Too much = excesse 
Number = numerade
Book/reading = biblify
Court/trial = tributrial
English = inglais
Hole = excavatiana
Photo = pictora
Scary = enfrightify
Hypothetical = hypothicus
Name = nam'e
Allowed = permitada
Understood = comprhande
Response = respondere
Feel = emotla
Create = shoota
Language = blabber 
If I understand correctly = meshoopita
Normal = stand
Fix = repairo
Words = parys
Different =sepe
Only = solo/ shell
Key = lockerpick
Encoded = lockerpicked
Online = netter
Translator = delocker
Fast = vroomvroom
Type = tippytappy
Confused = makeamedizzy
Flair = eshootyfire
Please = begga
Some = partii
With = inclu
For = perposa
Nevermind = forgo
Will = planna
Surprise = beezt
Educational = edulearnify
Inspired = cogname
Arguably = blabbable
Great = feary
Obvious/obviosness = cuale
Steal = arrrr
Account = bore
Give = kindle

